n 0 0 n 0 0 n 0 0 n 0 0 n 0 0 n 0 0 n 0 0 n 0 0 n 0 0 n 0 0 n 0 0 n 0 0 n 0 0
n 0 0 . 0 0 . 0 0 z 0 0 z 0 0 z 1 2 . 0 0 z 1 2 z 0 0 z 0 0 . 0 0 . 0 0 n 0 0
n 0 0 . 0 0 n 0 0 . 0 0 n 0 0 z 1 0 n 0 0 . 0 0 n 0 0 z 1 2 n 0 0 . 0 0 n 0 0
n 0 0 z 0 0 z 1 1 . 0 0 z 1 0 z 1 1 . 0 0 z 0 0 z 0 0 . 0 0 z 0 0 z 0 0 n 0 0
n 0 0 z 1 0 n 0 0 z 0 0 n 0 0 . 0 0 n 0 0 z 1 0 n 0 0 z 1 2 n 0 0 . 0 0 n 0 0
n 0 0 z 0 0 z 1 1 z 0 0 . 0 0 z 0 0 z 0 0 z 0 0 . 0 0 . 0 0 z 0 0 z 0 0 n 0 0
n 0 0 z 1 1 n 0 0 z 1 0 n 0 0 z 1 0 n 0 0 z 1 1 n 0 0 . 0 0 n 0 0 z 1 1 n 0 0
n 0 0 z 0 0 . 0 0 z 0 0 z 0 0 z 0 0 . 0 0 . 0 0 . 0 0 . 0 0 z 0 0 z 0 0 n 0 0
n 0 0 z 0 0 n 0 0 . 0 0 n 0 0 z 0 0 n 0 0 z 0 0 n 0 0 z 1 1 n 0 0 . 0 0 n 0 0
n 0 0 z 1 2 . 0 0 z 0 0 z 0 0 z 1 2 z 0 0 z 1 2 . 0 0 z 0 0 z 0 0 z 0 0 n 0 0
n 0 0 . 0 0 n 0 0 z 1 0 n 0 0 z 0 0 n 0 0 . 0 0 n 0 0 z 0 0 n 0 0 . 0 0 n 0 0
n 0 0 . 0 0 . 0 0 z 0 0 z 1 1 z 0 0 z 0 0 z 0 0 z 0 0 z 1 0 . 0 0 . 0 0 n 0 0
n 0 0 n 0 0 n 0 0 n 0 0 n 0 0 n 0 0 n 0 0 n 0 0 n 0 0 n 0 0 n 0 0 n 0 0 n 0 0
